################################################################################################################################
#                                                                                                                              #
#                                                                                                                              #
#                                                                                                                              #
#                                                                                                                              #
#                                                                                                                              #
#                                                                                                                              #
#                                                                                                                              #
#                                                                                                                              #
#                                                                                                                              #
#                                                                                                                              #
#                                                                                                                              #
#                                                                                                                              #
#                                                                                                                              #
#                                                                                                                              #
#                                                                                                                              #
#                                                                                                                              #
#                                                                                                                              #
#                                                                                                                              #
#                                                                                                                              #
#                                                                                                                              #
#                                                                                                                              #
#                                                                                                                              #
#                                                                                                                              #
#                                                                                                                              #
#                                                                                                                              #
#                                                                                                                              #
#                                                                                                                              #
#                                                                                                                              #
################################################################################################################################